TILEMAP
50 12 							-- Size of tile map in tiles
32 32							-- Tile size & block size
images/margaret/floor2.png      -- Office floor
1 1 							-- Number of tiles in tilesheet
00000000000000000000000000000000000000000000000000
00000000000000000000000000000000000000000000000000
00000000000000000000000000000000000000000000000000
00000000000000000000000000000000000000000000000000
00000000000011111111111111111111111111111111111111
11111111111111111111111111111111111111111111111111
11111100000000000000000111111111111111111111111111
11111111111111111111111111111111111111111111111111
11111111111111111111111111111111111111111111111111
11111111111111111111111111111111111111111111111111
11111111111111111111111111111111111111111111111111
11111111111111111111111111111111111111111111111111