TILEMAP
100 12 							-- Size of tile map in tiles
32 32							-- Tile size & block size
images/margaret/ok.png          -- OK floor
1 1 							-- Number of tiles in tilesheet
000000000000000066666666666666666666666666666666666666666666666666666639:366666666666666666666666666
000000000000000066666666666666666666666666666666666666666666666666666639:366666666666666666666666666
000000000000000066666666666666666666666666666666666666666666666666666639:366666666666666666666666666
000000000000000044444444444444444444444444444444444444444444444444444439:344444444444444444444444444
222222222222222255555555555555555555555555555555555555555555555555555539:355555555555555555555555555
111111111111111133333333333333333333333333333333333333333337773337773339:333333333333333333333333333
111111111111111133377733777333333333333333333333333333833333333333333339:333333333333333333333333333
111111111111111133333333333333333338333333333333333333333333333333333339:333333333333333333333333333
111111111111111133333333333333333333333333333377733777333333333333333839:333333333333333333333333333
111111111111111133333383333377777777333333383333333333333333333333333339:337777777733333333333333333
111111111111111133333333333333333333333333333333333333333337773337773339:333333333333333333333333333
111111111111111133333333333333333333333333333333333333333333333333333339:333333333333333333333333333