TILEMAP
100 12 							-- Size of tile map in tiles
32 32							-- Tile size & block size
images/margaret/ok.png          -- OK floor
1 1 							-- Number of tiles in tilesheet
822222222222222<=22222222222222222222222222222222222222222222222222222222222222222222222222222222222
400000000000000@A00000000000000000000000000000000000000000000000000000000000000000000000000000000000
400000000000000@A00000000000000000000000000000000000000000000000000000000000000000000000000000000000
400000000000000@A00000000000000000000000000000000000000000000000000000000000000000000000000000000000
400000000000000@A00000000000000000000000000000000000000000000000000000000000000000000000000000000000
400000000000000@A00000000000000000000000000000000000000000000000000000000000000000000000000000000000
400000000000000@A00000000000000000000000000000000000000000000000000000000000000000000000000000000000
400000000000000@A00000000000000000000000000000000000000000000000000000000000000000000000000000000000
400000000000000@A00000000000000000000000000000000000000000000000000000000000000000000000000000000000
400000000000000@A00000000000000000000000000000000000000000000000000000000000000000000000000000000000
400000000000000@A00000000000000000000000000000000000000000000000000000000000000000000000000000000000
933333333333333>?33333333333333333333333333333333333333333333333333333333333333333333333333333333333