TILEMAP
162 24 							-- Size of tile map in tiles
16 16							-- Tile size & block size
images/margaret/ok.png          -- OK floor
1 1 							-- Number of tiles in tilesheet
000000000000000000000000000000000000000000000000000000000000000000000000000000000000000000000000000000000000000000000000000000000000000000000000000000000000000000
000000000000000000000000000000000000000000000000000000000000000000000000000000000000000000000000000000000000000000000000000000000000000000000000000000000000000000
000000000000000000000000000000000000000000000000000000000000000000000000000000000000000000000000000000000000000000000000000000000000000000000000000000000000000000
000000000000000000000000000000000000000000000000000000000000000000000000000000000000000000000000000000000000000000000000000000000000000000000000000000000000000000
000000000000000000000000000000000000000000000000000000000000000000000000000000000000000000000000000000000000000000000000000000000000000000000000000000000000000000
000000000000000000000000000000000000000000000000000000000000000000000000000000000000000000000000000000000000000000000000000000000000000000000000000000000000000000
000000000000000000000000000000000000000000000000000000000000000000000000000000000000000000000000000000000000000000000000000000000000000000000000000000000000000000
000000000000000000000000000000000000000000000000000000000000000000000000000000000000000000000000000000000000000000000000000000000000000000000000000000000000000000
000000000000000000000000000000000000000000000000000000000000000000000000000000000000000000000000000000000000000000000000000000000000000000000000000000000000000000
001111111111110000000000000000000000111111112222220000000000000000000000000000000000000000000022220000000000000000000000000000222222222222222222222222000000000000
001111111111110000001100000011000000111111112222220000000000000000000000000000000000000000000022222222222222222222000000000000222222222222002222222222000000000000
001111111111111111111111111111111111111111112222220000000000000000000000000000000000000000000022333333333333333322000000000000222222002222222222002222000000000000
001111111111111111111111111111111111111111112222222222222222222222222222222222222222222222222222222222222222222222222222222222222222222222222222222222222200000000
001111111111111111111111111111111111111111112222222222222222222222222222222222222222222222222222222222222222222222333333333333222222222222222222222222222200000000
001111111111111100111111001111110011111111112222222200222222222200223333333322002222222222002222222222222222222222222222222222222222222222222222222222222200000000
001111111111110000001100000011000000111111112222222222222222222222223333333322222222222222222222222222333333222222222333222222222222222222222222222222222200000000
001111111111111100111111001111110011111111112222222222222222222222222222222222222222222222222222222222222222222222222222222222222222222222222222222222222200000000
001111111111110000001100000011000000111111112222222222222200222222223333333322222222002222222222222222222333332222222222222222222222222222222222222222222200000000
001111111111111100111111001111110011111111112222222200222222222200223333333322002222222222002222222222222223333222222223332222222222222222222222222222222200000000
001111111111110000001100000011000000111111112222222222222222222222222222222222222222222222222222222222222333222222222222223333222222222222222222222222222200000000
001111111111111111111111111111111111111111112222222222222222222222222222222222222222222222222222222222222222222222222223333332222222222222002222222222222200000000
001111111111111111111111111111111111111111112222222222222222222222222222222222222222222222222222222222222222222222222222222222222222002222222222002222222200000000
001111111111111111111111111111111111111111112222222222222222222222222222222222222222222222222222222222222222222222222222222222222222222222222222222222222200000000
000000000000000000000000000000000000000000000000000000000000000000000000000000000000000000000000000000000000000000000000000000000000000000000000000000000000000000