TILEMAP
100 24 							-- Size of tile map in tiles
16 16							-- Tile size & block size
images/margaret/ok.png          -- OK floor
1 1 							-- Number of tiles in tilesheet
0000000000000000000000000000000000000000000000000000000000000000000000000000000000000000000000000000
0000000000000000000000000000000000000000000000000000000000000000000000000000000000000000000000000000
0000000000000000000000000000000000000000000000000000000000000000000000000000000000000000000000000000
0000000000000000000000000000000000000000000000000000000000000000000000000000000000000000000000000000
0000000000000000000000000000000000000000000000000000000000000000000000000000000000000000000000000000
0000000000000000000000000000000000000000000000000000000000000000000000000000000000000000000000000000
0000000000000000000000000000000000000000000000000000000000000000000000000000000000000000000000000000
0000000000000000000000000000000000000000000000000000000000000000000000000000000000000000000000000000
0000000000000000000000000000000000000000000000000000000000000000000000000000000000000000000000000000
0011111111111100000000000000111122222200000000000000002200000000000000002222222222222222222222222222
0011111111111100000000000011111122222222222233332222222200000000000000002222222222222222222222222222
0011111111111111111111111111111122222222222233332222222200000000000000002222222222222222222222222222
0011111111111111111111111111111122222222002233332200222200000000000000002222222222222222222222222222
0011111111111111111111111111111122222222222233332222222200000000000000002222222222222222222222222222
0011111111111100000000111111111122222222222222222222222222222222222222222222233332222222222222222222
0011111111111100000000111111111122222222222222222222222222222222222222222222233332222222222222222222
0011111111111100000000111111111122222222222222222222222222222222222222222222233332222222222222222222
0011111111110000111111111111111122222222222222222222222222222222222222222222233332222222222222222222
0011111111111100111111111111111122222222222222222222222222222222222222222222222222222222222222222222
0011111111111100001111111111111122222222222222222222222222222222222222222222222222222222222222222222
0011111111111111111111111111111122222222222222222222222222222222222222222222222222222222222222222222
0011111111111111111111111111111122222200222222222222002222222222222222222222222222222222222222222222
0011111111111111111111111111111122222222222222222222222222222222222222222222222222222222222222222222
0000000000000000000000000000000000000000000000000000000000000000000000000000000000000000000000000000