TILEMAP
100 24 							-- Size of tile map in tiles
16 16							-- Tile size & block size
images/margaret/ok.png          -- OK floor
1 1 							-- Number of tiles in tilesheet
0000000000000000000000000000000000000000000000000000000000000000000000000000000000000000000000000000
0000000000000000000000000000000000000000000000000000000000000000000000000000000000000000000000000000
0000000000000000000000000000000000000000000000000000000000000000000000000000000000000000000000000000
0000000000000000000000000000000000000000000000000000000000000000000000000000000000000000000000000000
0000000000000000000000000000000000000000000000000000000000000000000000000000000000000000000000000000
0000000000000000000000000000000000000000000000000000000000000000000000000000000000000000000000000000
0000000000000000000000000000000000000000000000000000000000000000000000000000000000000000000000000000
0000000000000000000000000000000000000000000000000000000000000000000000000000000000000000000000000000
0000000000000000000000000000000000000000000000000000000000000000000000000000000000000000000000000000
0011111111111100000000000000111000000000000000002222222222222222222222222222222222222222222222222222
0011111111111100000000000011111002222222222222222222222222222222222222222222222222222222222222222222
0011111111111111111111111111111002222222222222222222222222222222222222222222222222222222222222222222
0011111111111111111111111111111002222222333322222222222222222222222222222222222222222222222222222222
0011111111111111111111111111111002222222333322222222222222222222222222222222222222222222222222222222
0011111111111100000000111111111112222222333322222222222222222222222222222222222222222222222222222222
0011111111111100000000111111111112222222333322222222222222222222222222222222222222222222222222222222
0011111111111100000000111111111112222222222222222222222222222222222222222222222222222222222222222222
0011111111110000111111111111111112222222222222222222222222222222222222222222222222222222222222222222
0011111111111100111111111111111002223333333222222222222222222222222222222222222222222222222222222222
0011111111111100001111111111111002223333333222222222222222222222222222222222222222222222222222222222
0011111111111111111111111111111002223333333222222222222222222222222222222222222222222222222222222222
0011111111111111111111111111111002223333333222222222222222222222222222222222222222222222222222222222
0011111111111111111111111111111002222222222222222222222222222222222222222222222222222222222222222222
0000000000000000000000000000000000000000000000000022222222222222222222222222222222222222222222222222