TILEMAP
100 12 							-- Size of tile map in tiles
32 32							-- Tile size & block size
images/margaret/ok.png          -- OK floor
1 1 							-- Number of tiles in tilesheet
0000000000000000666666666666666666666666666666666666666666666666666666639:36666666666666666666666666
0000000000000000666666666666666666666666666666666666666666666666666666639:36666666666666666666666666
0000000000000000666666666666666666666666666666666666666666666666666666639:36666666666666666666666666
0000000000000000444444444444444444444444444444444444444444444444444444439:34444444444444444444444444
2222222222222222555555555555555555555555555555555555555555555555555555539:35555555555555555555555555
1111111111111111333333333333333333333333333333333333333333333333333333339:33333333333333333333333333
1111111111111111333777337773333333333333333333333333333333333333333333339:33333333333333333333333333
1111111111111111333333333333333333333333333333333333333333333333333333339:33333333333333333333333333
1111111111111111333333333333333333333333333333333333333333333333333333339:33333333333333333333333333
1111111111111111333333333333777777773333333333333333333333333333333333339:33333333333333333333333333
1111111111111111333333333333333333333333333333333333333333333333333333339:33333333333333333333333333
1111111111111111333333333333333333333333333333333333333333333333333333339:33333333333333333333333333