TILEMAP
50 12 							-- Size of tile map in tiles
32 32							-- Tile size & block size
images/margaret/ok.png          -- OK floor
1 1 							-- Number of tiles in tilesheet
00000000000000006666666666666666666666666666666666
00000000000000006666666666666666666666666666666666
00000000000000006666666666666666666666666666666666
00000000000000004444444444444444444444444444444444
22222222222222225555555555555555555555555555555555
11111111111111113333333333333333333333333333333333
11111111111111113337773377733333333333333333333333
11111111111111113333333333333333333333333333333333
11111111111111113333333333333333333333333333333333
11111111111111113333333333333333333333333333333333
11111111111111113333333333333333333333333333333333
11111111111111113333333333333333333333333333333333