TILEMAP
50 24 							-- Size of tile map in tiles
16 16							-- Tile size & block size
images/margaret/ok.png          -- OK floor
1 1 							-- Number of tiles in tilesheet
00000000000000000000000000000000000000000000000000
00000000000000000000000000000000000000000000000000
00000000000000000000000000000000000000000000000000
00000000000000000000000000000000000000000000000000
00000000000000000000000000000000000000000000000000
00000000000000000000000000000000000000000000000000
00000000000000000000000000000000000000000000000000
00000000000000000000000000000000000000000000000000
00000000000000000000000000000000000000000000000000
00111111111111000000000000001110022222222222222222
00111111111111000000000000111110022222222222222222
00111111111111111111111111111110022222222222222222
00111111111111111111111111111110022222223333222222
00111111111111111111111111111110022222223333222222
00111111111111000000001111111111122222223333222222
00111111111111000000001111111111122222223333222222
00111111111111000000001111111111122222222222222222
00111111111100001111111111111111122222222222222222
00111111111111001111111111111110022233333332222222
00111111111111000011111111111110022233333332222222
00111111111111111111111111111110022233333332222222
00111111111111111111111111111110022233333332222222
00111111111111111111111111111110022222222222222222
00000000000000000000000000000000000000000000000000