TILEMAP
50 12 							-- Size of tile map in tiles
32 32							-- Tile size & block size
images/margaret/floor2.png      -- Office floor
1 1 							-- Number of tiles in tilesheet
822222222222222<=22222222222222222222222222222222:
400000000000000@A000000000000000000000000000000005
400000000000000@A000000000000000000000000000000005
400000000000000@A000000000000000000000000000000005
400000000000000@A000000000000000000000000000000005
400000000000000@A000000000000000000000000000000005
400000000000000@A000000000000000000000000000000005
400000000000000@A000000000000000000000000000000005
400000000000000@A000000000000000000000000000000005
400000000000000@A000000000000000000000000000000005
400000000000000@A000000000000000000000000000000005
933333333333333>?33333333333333333333333333333333;