TILEMAP
75 12 							-- Size of tile map in tiles
32 32							-- Tile size & block size
images/margaret/ok.png          -- OK floor
1 1 							-- Number of tiles in tilesheet
000000000000000066666666666666666666666666666666666666666666666666666666666
000000000000000066666666666666666666666666666666666666666666666666666666666
000000000000000066666666666666666666666666666666666666666666666666666666666
000000000000000044444444444444444444444444444444444444444444444444444444444
222222222222222255555555555555555555555555555555555555555555555555555555555
111111111111111133333333333333333333333333333333333333333333333333333333333
111111111111111133377733777333333333333333333333333333333333333333333333333
111111111111111133333333333333333333333333333333333333333333333333333333333
111111111111111133333333333333333333333333333333333333333333333333333333333
111111111111111133333333333377777777333333333333333333333333333333333333333
111111111111111133333333333333333333333333333333333333333333333333333333333
111111111111111133333333333333333333333333333333333333333333333333333333333