TILEMAP
100 12 							-- Size of tile map in tiles
32 32							-- Tile size & block size
images/margaret/ok.png          -- OK floor
1 1 							-- Number of tiles in tilesheet
222222222222222<=22222222222222222222222222222222222222222222222222222222222222222222222222222222222
000000000000000@A00000000000000000000000000000000000000000000000000000000000000000000000000000000000
000000000000000@A00000000000000000000000000000000000000000000000000000000000000000000000000000000000
000000000000000@A00000000000000000000000000000000000000000000000000000000000000000000000000000000000
000000000000000@A00000000000000000000000000000000000000000000000000000000000000000000000000000000000
000000000000000@A00000000000000000000000000000000000000000000000000000000000000000000000000000000000
000000000000000@A00000000000000000000000000000000000000000000000000000000000000000000000000000000000
000000000000000@A00000000000000000000000000000000000000000000000000000000000000000000000000000000000
000000000000000@A00000000000000000000000000000000000000000000000000000000000000000000000000000000000
000000000000000@A00000000000000000000000000000000000000000000000000000000000000000000000000000000000
000000000000000@A00000000000000000000000000000000000000000000000000000000000000000000000000000000000
333333333333333>?33333333333333333333333333333333333333333333333333333333333333333333333333333333333