TILEMAP
150 24 							-- Size of tile map in tiles
16 16							-- Tile size & block size
images/margaret/ok.png          -- OK floor
1 1 							-- Number of tiles in tilesheet
000000000000000000000000000000000000000000000000000000000000000000000000000000000000000000000000000000000000000000000000000000000000000000000000000000
000000000000000000000000000000000000000000000000000000000000000000000000000000000000000000000000000000000000000000000000000000000000000000000000000000
000000000000000000000000000000000000000000000000000000000000000000000000000000000000000000000000000000000000000000000000000000000000000000000000000000
000000000000000000000000000000000000000000000000000000000000000000000000000000000000000000000000000000000000000000000000000000000000000000000000000000
000000000000000000000000000000000000000000000000000000000000000000000000000000000000000000000000000000000000000000000000000000000000000000000000000000
000000000000000000000000000000000000000000000000000000000000000000000000000000000000000000000000000000000000000000000000000000000000000000000000000000
000000000000000000000000000000000000000000000000000000000000000000000000000000000000000000000000000000000000000000000000000000000000000000000000000000
000000000000000000000000000000000000000000000000000000000000000000000000000000000000000000000000000000000000000000000000000000000000000000000000000000
000000000000000000000000000000000000000000000000000000000000000000000000000000000000000000000000000000000000000000000000000000000000000000000000000000
001111111111110000000000000011112222220000000000000000220000000000000000000000000000000000000000000000000000000000002222222222222222222222000000000000
001111111111110000000000001111112222222222223333222222220000000000000000000000000000222222222222222222222222222222222222002222222222002222000000000000
001111111111111111111111111111112222222222223333222222220000000000000000000000000000222222222222222222222222222222222222222222002222222222000000000000
001111111111111111111111111111112222222200223333220022220000000000000000222222222222222222222222222222222222222222222222222222222222222222222200000000
001111111111111111111111111111112222222222223333222222220000000000000000222222222222222222222222222222222222222222222222222222222222222222222200000000
001111111111110000000011111111112222222222222222222222222222222222222222222223333222222222222222222222222222222222222222222222222222222222222200000000
001111111111110000000011111111112222222222222222222222222222222222222222222223333222222222222222222222222222222222222222222222222222222222222200000000
001111111111110000000011111111112222222222222222222222222222222222222222222223333222222222222200222222220022222222222222222222222222222222222200000000
001111111111000011111111111111112222222222222222222222222222222222222222222223333222222222222222222222222222222222222222222222222222222222222200000000
001111111111110011111111111111112222222222222222222222222200222222220022222222222222222222222222222222222222222222222222222222222222222222222200000000
001111111111110000111111111111112222222222222222222222222222222222222222222222222222222222222222222222222222222222222222222222222222222222222200000000
001111111111111111111111111111112222222222222222222222222222222222222222222222222222222222222222222222222222222222222222002222222222002222222200000000
001111111111111111111111111111112222220022222222222200222222222222222222222222222222222222222222222222222222222222222222222222002222222222222200000000
001111111111111111111111111111112222222222222222222222222222222222222222222222222222222222222222222222222222222222222222222222222222222222222200000000
001111111111111111111111111111112222222222222222222222222222222222222222222222222222222222222222222222222222222222222222222222222222222222222200000000